w,w,w,w,w,w,w,w,w,w,w,w
w,f,f,f,f,f,f,f,f,f,f,w
w,f,f,f,f,f,f,f,f,f,f,w
w,f,f,f,f,f,f,f,f,f,f,w
w,f,f,f,f,f,f,f,f,f,f,w
w,f,f,f,f,f,f,f,f,f,f,w
w,f,f,f,f,f,f,f,f,f,f,w
w,f,f,f,f,f,f,f,f,f,f,w
w,f,f,f,f,f,f,f,f,f,f,w
w,f,f,f,f,f,f,f,f,f,f,w
d,f,f,f,f,f,f,f,f,f,f,w
w,w,w,w,w,w,w,w,w,w,w,w
